1111111111111
1001000P000C1
1000011111001
100011E000001
1111111111111
