1111111111111
1C01000P00CC1
1CC0011111001
10CC11E000001
1111111111111
