1111111111111
1C00000P00CC1
10CC110000001
1C01000000CC1
1CC0011111001
10CC10E000001
1111111111111
