111111111111
1C00000P00C1
1CC001111101
10CC11000001
1C01000000C1
1CC001111101
10CC10E00001
111111111111
